23 23
330 450 
0 0 0 0 0 0 0 0 0 0 0 0 0 0 0 0 0 0 0 0 0 0 0
3 3 3 3 3 3 3 3 3 3 3 3 3 3 3 3 3 3 3 3 3 3 3 
3 2 1 1 1 1 1 1 1 1 1 3 1 1 1 1 1 1 1 1 1 2 3 
3 1 3 3 3 1 3 3 3 3 1 1 1 3 3 3 3 1 3 3 3 1 3  
3 1 3 3 3 1 3 3 3 3 1 3 1 3 3 3 3 1 3 3 3 1 3  
3 1 1 1 1 1 1 1 1 1 1 3 1 1 1 1 1 1 1 1 1 1 3 
3 1 3 3 3 1 3 1 3 3 3 3 3 3 3 1 3 1 3 3 3 1 3 
3 1 1 1 1 1 3 1 1 1 1 3 1 1 1 1 3 1 1 1 1 1 3 
3 3 3 1 3 1 3 3 3 3 1 3 1 3 3 3 3 1 3 1 3 3 3  
3 1 1 1 3 1 0 0 0 0 0 0 0 0 0 0 0 1 3 1 1 1 3  
3 1 3 3 3 1 3 0 3 3 3 4 3 3 3 0 3 1 3 3 3 1 3  
3 1 1 1 1 1 3 0 3 0 0 0 0 0 3 0 3 1 1 1 1 1 3  
3 1 3 3 3 1 3 0 3 3 3 3 3 3 3 0 3 1 3 3 3 1 3  
3 1 1 1 3 1 3 0 0 0 0 0 0 0 0 0 3 1 3 1 1 1 3  
3 3 3 1 3 1 3 0 3 3 3 3 3 3 3 0 3 1 3 1 3 3 3  
3 1 1 1 1 1 0 0 0 0 0 0 0 0 0 0 0 1 1 1 1 1 3 
3 1 3 3 3 1 3 3 3 3 1 3 1 3 3 3 3 1 3 3 3 1 3 
3 2 1 1 3 1 1 1 1 1 1 3 1 1 1 1 1 1 3 1 1 2 3 
3 3 3 1 3 1 3 1 3 3 3 3 3 3 3 1 3 1 3 1 3 3 3 
3 1 1 1 1 1 3 1 1 1 1 3 1 1 1 1 3 1 1 1 1 1 3 
3 1 3 3 3 1 3 3 3 3 1 3 1 3 3 3 3 1 3 3 3 1 3 
3 1 1 1 1 1 1 1 1 1 1 1 1 1 1 1 1 1 1 1 1 1 3  
3 3 3 3 3 3 3 3 3 3 3 3 3 3 3 3 3 3 3 3 3 3 3 
